--------------------------------------------------------------------------------------------------------------------------------------------------------------------------------------------------------------------------------------------------------------------------------------------------------------------------------------------------------------------------------------------------------------------------------------------------------------------------
-----------------------------------------------------------------------------------------------------------------------------------------------------------------------------------------------------------------------------------------------------------------------------------------------------------------------------------------------------------------------------------------------------------------------------------------------------------------------F--
----------------------------------------------------------------------------------------------------------------------------------------------------------------------------------------------------------------------------------------------------------------------------------------------------------------------------------------------------------------------------------------------------------------------------------------------------------------------FF--
-------------------------------------S------------------------------------------------------------------------------------------------------------------------------S--------------------------------------------------------------------------------------------------------------------CC-----------------------------------------------------S-----------------------------------------------------------------------------------------------------------------^----F--
------------------------------------BOB----------------------------------------------------------------------------------------------------------------------------BO-----------------------------------------------------------------------------------------------------------------BBBOOBB--------------------------------------------------BOB---------------------------------------------?------------------------------------------------------------------O----F--
-----------------------------------------------------------------------------------------------------------------------------------------------------------------------------------------------------------------------------------------------------------------------------------------------------------------------------------------------------------------------------------------------------------------------------------------------------------------------F--
------------------------------------------------------------Y------------------------------------------------YYY-----------------------------------------------------------------------------------------------------------------------------------------------------------------------------------------------------------------------------------------------------------------------------------------------------------^-------------------------------------------F--
------------------------------------------------------------P------------------------------------------------PPP--------------------------------------------------------------------------------YY----------------------------------------------------------------------------------------------------------------------------------------------------------------------------------------------C--------------------------O-------------------------------------------F--
-----------------------------------WWWWW--------------------P--------------------------------------YY--------PPP-------------------YY-----------------------------WWW--------Y------------------PP--------------------------------------------Y-----YY-------------------------------WW--OO---------------------------------------------------WWWWW--------------------------------------------?----------------------------------------------------------------????---F--
-----------------------------------W------------------------P--------------------------------------PP--------PPP-------------------PP-----------------------------W----------P-----YY-----------PP-------------Y------------------------------P-----PP-------------------------------W-----A--------------------------------------------------W--------------------A---CR-------A---YY------------------------------------Y--------YY----------------------------------F--
-----------------------------------W------------------------P--------------------------------------PP--------PPP-------------------PP-----------------------------W----------P-----PP-----------PP-------------P------------------------------P-----PP-------------------------------W--------------------------------------------------------W-------------<N---------OO-----------PP------------------------------------P--------PP----------------------------------F--
--M--------------------------------W------------------------P--------K--------K-----------G-GGGG---PP--------PPP--------K-------K--PP-----------------------------W----------PK----PP-----K--K--PP-------------P--------------------------K---P-----PP----------G------------------K-W-----------------------------------K-------K--K---------W--------------V----------------------PP------------------------------------P--------PP----------------------------------W--
======================================---=========--===-----=====================------===========-==-===----===================================================================================================-====-----===================-=-==--===================================================--===-----================================----================================================================================================---==================
======================================---=========--===-----=====================------===========-==-===----===================================================================================================-====-----===================-=-==--===================================================--===-----================================----================================================================================================---==================
