----------------------------------------------------------------------------------------------------------------------------------------
----------------------------------------------------------------------------------------------------------------------------------------
-------------------------------------------------------------------------------------------------------------------------------------F--
------------------------------------------------------R-R-------------------------------------------------------------------------------
---------------------------BBBBBB---BBB?--------------?-?-------------------------------------------------------------------WW----------
---------------------------------------------------------------------------------------------------------------------------WWW----------
--------------------------------------------------------------------------------------------------------------------------WWWW----------
---------------------------------------C------S-------------------------YY----YY-----------C-----------------------------WWWWW----------
-----------------------AA--------------B-----BO----?--?-?---?-----------PP----PP----------------------------------------WWWWWW----------
------------------------------------------------------------------------PP----PP---------------W-----------------------WWWWWWW----------
-------------------------<W---------------------------------------------PP----PP----W----------W----------------------WWWWWWWW----------
--M-----------------------W-------------GG---------K--------------------PP----PP----W----------W---------------------WWWWWWWWW----------
===============================---=================================================-=-==========--======================================
===============================---=================================================-=-==========--======================================