-----------------------------------------------------------------------------------------------------------------------------
--------------------------------------------------------------------------------------------------------------------------F--
-------------------------------------------------------------------------------------------------------------------------FF--
---------------------------------------------------------------------------------------------------------------------^----F--
----------------------?-----------------------------------------------???--------------------------------------------O----F--
--------------------------------------------------------------------------------------------------------------------------F--
--------------------------------------------------------------------------------------------------------------------------F--
---------------------R------------------------------------------------R---------------------------------------------------F--
----------------?---B?B?B-------------A-----------------------------???BB-??---------------------------------------????---F--
--------------------------------------------------------------------------------------------------------------------------F--
--------------------------------PP----------------------------------------------------------------------------------------F--
--M------------------G-G--------PP-----KK--K--K---------------------------------------K--K--K-----------------------------W--
==========================================================---==========--===============================----=================
==========================================================---==========--===============================----=================
