-------------------------------------------------------------------------------
----------------------------------------------------------------------------F--
---------------------------------------------------------------------------FF--
----------------------------------------------------------------------------F--
----------------------?-----------------------------------------------------F--
----------------------------------------------------------------------------F--
------------------------------------------------------------------^---------F--
---------------------R--------------------------------------------O---------F--
----------------?---B?B?B-----------------------PP--------PP----------------F--
----------------------------------------PP------PP--------PP----------------F--
----------------------------------------PP------PP--------PP----------------F--
--M------------------G------------------PP------PP------G-PP----------------W--
=======================================================================--======
=======================================================================--======
