---------------------------------------------------------------------------------------------------------------------------------------------------------------------------------------------------------
------------------------------------------------------------------------------------------------------------------------------------------------------------------------------------------------------F--
-----------------------------------------------------------------------------------------------------------------------------------------------------------------------------------------------------FF--
----------------------------------------------------------------------------------G--------------------------R----------------------------------------------------------------------------------------T--
----------------------?---------------------------------------------------------BBBBBBBB---BBB?--------------?-----------BBB----B??B--------------------------------------------------------WW--------T--
-------------------------------------------------------------------------------------------------------------------------------------------------------------------------------------------WWW--------T--
----------------------------------------------------------------U--------------G----------------------------------------------------------------------------------------------------------WWWW--------T--
---------------------R------------------------------------------O-------------R---------------C------S-----------------------------------------------------------------------------------WWWWW--------T--
----------------?---B?B?B---------------------PP---------PP------------------B?B--------------B-----BO----?--?--?-----B----------BB------W--W----------WW--W------------BB?B------------WWWWWW--------T--
--------------------------------------PP------PP---------PP-----------------------------------------------------------------------------WW--WW--------WWW--WW--------------------------WWWWWWW--------T--
----------------------------PP--------PP------PP---------PP----------------------------------------------------------------------------WWW--WWW------WWWW--WWW-----PP--------------PP-WWWWWWWW--------T--
--M------------------G------PP--------PPG-----PP-----GG--PP------------------------------------GG---------K----------------G-G-GG-----WWWW--WWWW----WWWWW--WWWW----PP--------G-G---PPWWWWWWWWW--------W--
=====================================================================--===============---================================================================--==============================================
=====================================================================--===============---================================================================--==============================================