------------------------------------------------------------------------------------------------------------------------------------------------------------------------------------------------------------------------------------
---------------------------------------------------------------------------------------------------------------------------------------------------------------------------------------------------------------------------------F--
---------------------------------L----------------------------------------------------------------------------------------------------------------------------------------------------------------------------------------------FF--
--------------------------------------------------------------------------------------------U------------------------------------------------------------------------------------------------------------------------------------T--
-------------------------?--------------------------------------?-?-------------------------O-------------------------------------------------------????---------------------------------------------------------------WW--------T--
---------------------------------------------------------------------------------------------------------CCCC----------CCCC------------CCCC---------------------------------------------------------------------------WWW--------T--
---------------------------------------------------------------------------------------------------------------------------------------------------------------------------------------------------------------------WWWW--------T--
-------------------------R----------------CC------------------------------------------------------------------------YY--------------YY--------------R---------------------------------------------------------------WWWWW---C----T--
---------------------YY--?---------------C--C-------------------?-?-----------------------????----------------------PP--------------PP------------???BB???---------------------------------------------------------WWWWWW---O----T--
---------------------PP--------------------------------------------------------------------------------W------------PP--------------PP-----------------------------YY------------------------W--------------------WWWWWWW--------T--
---------------------PP--------------------------------------------------------------------------------W------------PP--------------PP-----------------------------PP------------------------W-------------------WWWWWWWW--------T--
--M------------------PP----X---------------------------------------------------------------------------W------------PP--------------PP-----------------------------PP------------------------W------------------WWWWWWWWW--------W--
================================--============================================----===================================================================--=======================---===--========--====================================
================================--============================================----===================================================================--=======================---===--========--====================================