-------------------------------------------------------------------------------------------------------------------------------!------------------------------------------------------------------------------------------------------------------------------------------------------------------------------------
-------------------------------------------------------------------------------------------------------------------------------!---------------------------------------------------------------------------------------------------------------------------------------------------------------------------------F--
---------------------------L---------------------------------------------------------------------------------------------------!--------------------------------------------------------------------------------------------------------------------------------------------------------------------------------FF--
-------------------------------------------------------------------------------------------------------------------------------!--------------------------------S--------------------------------------------------------------------H---------------------------------------------------------------------------T--
------------------------------------------------------------------------------------------------------------------------------BO-------------------????---------OBB--------------WW----------------------------------------------BBBBBB------------------------------------------------------------A---WW--------T--
---------------------------------------------------------------------------------------------------------------------------------------------------------------------------------WW--------------------------------------------------------------------------------------------------------------------WW--------T--
----------------------------------------------W-----------------------------------------------------------------W----------------------------------------------------------------WW--------------------------------------------------------------------------------------------------------------------WW--------T--
---------------------------------------------WW--CC------C----C------------------B---<N-----------------------WWW---------------B--B---------------R--------------------------W--WW------------------------------------------------H----------------------------------------------GW----------------W--WW--------T--
--------------------------------------------WWW--------------------------------------BWW------W----B---------WWWW--------????-------------------AAK????---------B---?-----?YYWW--WW-----------?------------B----------????-------BBBBBB-?----------------YY-------------BB--------WW----------------W--WW--------T--
---------------------YY--------------------WWWW----------------------------------------W-----WW-------------WWWWW----------------W---------------------------------A-------PPWW--WW----------------------------------------------------A-----------------PP----YY----------------WWW---<N---------W-W--WW--------T--
---------------------PP-------------------WWWWW----------------------WW-----<N----WW---W----WWW-----PP----WWWWWWW----------------W-----------------------------<-----------PPWW--WW-------W-------A------------------------------------------------<N----PP----PP-----<N-------GWWWW----V--------WW-W--WW--------T--
--M------------------PP-------------G-G--WWWWWW-E--------------------WW------V----WW-E-W---WWWW-----PP----WWWWWWW----------------W-C---------------------G-GG---G----------PPWW--WW-------W---K-------------------------------^---------------------V----PPK---PPK-----V-------WWWWW-E-<N-------WWW-W--WW--------W--
========================================================---==---================-=================================================-=---========================-=====-=========--=======================--==---===========================================================--=======================-=-==============
========================================================---==---================-=================================================-=---========================-=====-=========--=======================--==---===========================================================--=======================-=-==============
