-------------------------------------------------------------------------------------------------------------------------------------------------------R------------------------------
-------------------------------------------------------------------------------------------------------------------------------------------------------O---------------------------F--
----------------------------------------------------------------------------------------------------------------------------------------------------------------------------------FF--
---------------------------R----------------------------------------------------------H------U-------------------------------------------------------------------------------------T--
---------------------------OBB----------------------------------------------------BBBBBBB----O----------------------------------------BBBBB------------------------------WW--------T--
---------------------------------------------------------------------------------------------------------------------------------------------------------BB------------EWWW--------T--
---------------------------------------------------------------<N---------------------------------------------------------------------------------------------W--------WWWW--------T--
----------------------------------------------------------------VC------------------H--------------------------------------------------H-------------BB------WW-------WWWWW--------T--
---------------------------------------????-------------------BBWOB---------YY----BBBBBBB----YY--------------YY-----------------------BBBBB-----------------WWW------WWWWWW--------T--
-----------------------A---<N----------------<N----A---<N-------------------PP---------------PP--------------PP----YY-----------YY-----------W---<N--------WWWW-----WWWWWWW--------T--
------------------<N--------V------<N-A-------V---------V----------<N-------PP---------------PP--------<N----PP----PP----<N-----PP-----------W----V-------WWWWW----WWWWWWWW--------T--
--M----------------V-------<N-------V---------|--------<N-----------V-------PP---------------PP---------V----PPK---PP-----V-----PP------H----W---<N----^-WWWWWW---WWWWWWWWW--------W--
=========================================================================--=============================================================================-=============================
=========================================================================--=============================================================================-=============================