-------------------------------------------------------------------------------------------------------------------------------------------------------------------------------------------------------------------------------------------------------------------------------------------------------------------------------------------------------------------------------------------
----------------------------------------------------------------------------------------------------------------------------------------------------------------------------------------------------------------------------------------------------------------------------------------------------------------------------------------------------------------------------------------F--
---------------------------------------------------------------------------------------------------------------------------------------------------------------------------------------------------------------------------------------------------------------------------------------------------------------------------------------------------------------------------------------FF--
-------------------------------------------------------------------------------------------------------------CC-----------------------------------------------C-------------------------------------------------------------------------------------------------------------------------------------------------------------------------------------------------------------------------T--
----------------------------------------------------------------------------------------------------------------------------------------------------------BBBBOBBB------------------------------------------------------------------------------------------------------------------------------------------------------------------------------------------------------------WW--------T--
------------------------------------------------------------------------------------------------------------------------------------------------------------------------------------------------------------------------------------------------------------------------------------------------------------------------------------------------------------------------------WW--------T--
--------------------------------------------------------------------------------U---------------------------------------------------------------------------------------------------------S-----------------------------------------------------------YY--------------------------------W-----------------------------------------------------------------------------------W-WW--------T--
-----------------------------------YY---------------------------C-----------YY--O--------C----YY--C-----YY------------------------------------------------------------------------------BBOBBBBB-------------------------------CC-----------------YY--PP-------------------------------WW--CC------C----C-------------------CC---CC-----------------------------------------W-WW--------T--
-----------------------------------PP---------------------------------------PP----YY----------PP--------PP----------------------------------YY-----------W----O----W--------------------------------------------------------------------------YY--PP--PP------------------------------WWW---------------------------------------------------------------YY----------------W-W-WW--------T--
-----------------------------------PP---------------------------------------PP----PP----------PP--------PP---------YY-----------------------PP-----------W-----A---W-------A------------------------------------------------------------------PP--PP--PP-----------------------------WWWW---------------------------------------------------------------PP---------YY-----W-W-WW--------T--
-----------------------------------PP---------------------------------------PP----PP----------PP--------PP---------PP-----------------------PP-----------W---------W-----------A----------------------------------W---------------------------PP--PP--PP----------------------------WWWWW----------------------W---W------------------------------------PP---------PP---W-W-W-WW--------T--
--M-----------E------GG-G------G---PP----K-K--------------K---------G-GG----PP--E-PP----------PP--------PP-GG-G----PPK------K---K-KK--------PP-----GG-G--W---------W-----------------------------------------K-K--W--------------------G-GG---PP--PP--PP---E---G-GG---G--------G---WWWWWW-E--------------------WK--W-----------------------K------KK-K--PP---------PP---W-W-W-WW--------W--
==============================================-=-==-==-==-===============================================================================================================-=-==-=-==-=================-=-=-===================------==========-==--==--============================================---==---================-----=----===================================-=-=-=-=============
==============================================-=-==-==-==-===============================================================================================================-=-==-=-==-=================-=-=-===================------==========-==--==--============================================---==---================-----=----===================================-=-=-=-=============