---------------------------------------------------------------------------------------------------------------------------------------------------------------------------------------------------------------------------
-----------------------A------------------------------------------------------------------------------------------------------------------------------------------------------------------------------------------------F--
---------------------L-------------------------------------------------------------------------------------------------------------------------------------------------------------------------------------------------FF--
--------------------------------------------U---------------------------------------------------------------------------------------------------------------------------------------------------------------------------T--
------------------------WW-----------------BOBBBBBBBBBBBBBBBBBBBBBBBBBBBBBBB------------------------------------------------------------------------------------------------------------------------------A---WW--------T--
-----------------------WWW------------------------------------------------------------------------------------------------------------------------------------------------------------------------------------WW--------T--
----------------------WWWW------------------------------------------------------------------------------------------------------------------------------------------------------------------------------------WW--------T--
----------------------WWWW--------------------------------------------------------------------------R-----------------<NC-----------------------------------YY---------------------------GW----------------W--WW--------T--
--------------------W-WWWW---????---------------------A------------A---------BB--------------------BO---------BB------BWO-----------------------------------PP---------A-----A-----------WW----------------W--WW--------T--
---------------A---WW-WWWW--------------------------------------A---------------------------<NA-----------------------------<N-----YY----A----YY------------PP-----YY-------------------WWW---<N---------W-W--WW--------T--
------------------WWW-WWWW----------------------------------------------------------<N----A--V----------<N-------------------V-----PP---------PP------------PP-----PP----A----<N------GWWWW----V--------WW-W--WW--------T--
--M--------------WWWW-WWWW------------------^----------------------------------------V------<N-----------V--E-----<N--E-E----|-----PP---------PP------------PP-----PP----------V------WWWWW-E-<N-------WWW-W--WW--------W--
===============-=====-==============-========-====-=-===-======-==============--====-=====================================================-=====-=-=------====================-=---=======================-=--=============
===============-=====-==============-========-====-=-===-======-==============--====-=====================================================-=====-=-=------====================-=---=======================-=--=============