-----------------------------------------------------------------------------------!-----------------------------------------------------------------------------------------------------------------------
-----------------------------------------------------------------------------------!--------------------------------------------------------------------------------------------------------------------F--
-----------------------------------------------------------------------------------!----------------------------------------------------------------------------------------------------------WW-------FF--
----------------------------U----------------------------------------S-------------!-----------------------------------------R----------------------------------------------R-----------------WW--------T--
----------------------------OBBB---------------------?????-----------OBBB--------BBOBB------BBBB-----------------------------OBBB-----------------------------------BBBBB---O-------------O---WW--------T--
----------------------------------------------------------------------------------------------------------------------------------------------------------------------------------------------WW--------T--
----------------------------------------------------------------------------------------------------------------------------------YY----------------------------------------------------------WW--------T--
----------------R-------W---------------------YY-----R--------------------YY---------------------------YY-----------------YY------PP-----------------------------C----------------------------WW--------T--
---------------BOB----GWW---O-----W-----------PP----K?????----------B-----PP---????--???---------------PP-----------------PP--YY--PP-----------------------------O---A----?-----YY-------BB---WW--------T--
----------------------WWW---------W-----------PP--------------------------PP---------------------------PP----------YY-----PP--PP--PP----------------------W--------------A------PP------------WW--------T--
---------------------WWWW---------WW----------PP--------------------------PP---------------------------PP----------PP-----PP--PP--PP-----------------A----W---------------------PP------------WW--------T--
--M-----------------WWWWW---K-K---WW--GG------PP-----------GG---K-G-GG----PP-------GG-G------------G---PP--------G-PP--G--PP--PP--PP----------------------W----G-G--------------PPK---------^-WW--------W--
============================================================================================----==========---==============================---==========--=================================================
============================================================================================----==========---==============================---==========--=================================================