----------------------------------------------------------------------------------------------------------------------------------------------------------------------------------------------------------
-------------------------------------------------------------------------------------------------------------------------------------------------------------------------------------------------------F--
------------------------------------------------------------------------------------------------------------------------------------------------------------------------------------------------------FF--
-------------------------------------------------------------------------------------------S-----------------------------------------------------------------------------------------------------------T--
------------------------------------------------------------------------------------------BOB------------------------------------------------------------------------------------------------WW--------T--
------------------------------------------------------------------------------------------------------------------------------------------------------------YY-------------------------------WW--------T--
------------------------------------------------------------------------------------------------------------------------------------------------------------PP-------------------------------WW--------T--
----------------------------------------------------------------------------------------------------------------------------------------------------U-------PP----------------------------W--WW--------T--
--------------------------------------------YY-----YY------------------------------A-----WWWWW-----------------------------------------------------WOBB-----WW---------------------------WW--WW--------T--
--------------------------------------------PP-----PP----A-------------------------------W--------------------------W------------------------------W---------------YY-----------A---A---WWW--WW--------T--
--------------------------------------------PP-----PP------------------------------------W--------------------<N----W------------------------------W----------<N---PP----<N------------WWWW------------T--
--M------------K--GG-G-------GG-G----K------PP-----PP----------GG-G-----G-GG-------------W------------G-GG-----V----W--G-GG---K------G----------KK-W-----------V---PP-----V-----------WWWWW------------W--
=================================================--=========================================----==================--====================================---===============================================
=================================================--=========================================----==================--====================================---===============================================