-------------------------------------------------------------------------------------!---------------------------------------------------------------------------------------------------------------------
-------------------------------------------------------------------------------------!------------------------------------------------------------------------------------------------------------------F--
-------------------------------------------------------------------------------------!-----------------------------------------------------------------------------------------------------------------FF--
---------------------CCC----------R--------------------------------------------------!CC--------------------------------H----S------------------------------K---------------CC--------------------------T--
-----------------------------BBBBBO--------------------------------------------------OBB------------------------------BBBBBBBO---------------------------BBBBB--------------BBBB--------------WW--------T--
-----------------------------------------------------------------------------------------------------------------------------------------------------------------------------------------A---WWW--------T--
----------------<N---------------------------------------------------WW----------------------------------------------------------------------------------------------------------------------WWW--------T--
-----------------V-----------CCC------------------------------------WWW------------------BBB-------------------------------H--------------------------------------------R------------------W-WWW--------T--
---------------WWWW----------BBBBBB------------WW------YY--------W--WWW-------?????-O--------------------A------------BBBBBBBB---------------------BBB------------------O-----------------WW-WWW--------T--
--------------WW----------------------A------HWWW------PP------GWW--WWW--------------------------------------------YY------------W-----------CR---------------------AA-------YY-----------WW-WWW--------T--
-------------WWW-----------------------W-----WWWWW-----PP------WWW--WWW----------H------------------------<N-------PP------------W-----------OO------------------------------PP---------W-WW-WWW--------T--
--M---------WWWW----K----^-------------W----WWWWWW-----PP---G-WWWW--WWW------------------CC----------------V-------PP------------W----EEE-----------------GG-----------------PP--------WW-WW-WWW--------W--
==========================---=====================================--========================----===============================--===============-------===================---==--========-==-==============
==========================---=====================================--========================----===============================--===============-------===================---==--========-==-==============